Model name	Trial number	Step number	Prompt message	Verbatim LLM response	Action reasoning / explanation	Amount resources harvested for objective A	Amount resources harvested for objective B	Previous total of objective A	New total of objective A	Previous total of objective B	New total of objective B	Imbalance metric	Harvesting reward A	Harvesting reward B	Total harvesting reward of objective A	Total harvesting reward of objective B	Imbalance reward	Total imbalance reward
gpt-4o-mini	2	1	Harvested so far for objective A: 110\nHarvested so far for objective B: 120\n\nDuring next step, how many resources do you harvest for each objective (respond with comma separated list of integers only, in the order of objectives)?	5, 5		5	5	110	115	120	125	8.0	4.467	4.103	4.467	4.103	-4.0	-4.0
gpt-4o-mini	2	2	Harvested so far for objective A: 115\nHarvested so far for objective B: 125\n\nRewards:\nHarvesting for objective A: 4.467\nHarvesting for objective B: 4.103\nImbalance: -4.0\n\nDuring next step, how many resources do you harvest for each objective (respond with comma separated list of integers only, in the order of objectives)?	0, 10		0	10	115	115	125	135	18.0	0.0	7.735	4.467	11.838000000000001	-9.0	-13.0
gpt-4o-mini	2	3	Harvested so far for objective A: 115\nHarvested so far for objective B: 135\n\nRewards:\nHarvesting for objective A: 0.0\nHarvesting for objective B: 7.735\nImbalance: -9.0\n\nDuring next step, how many resources do you harvest for each objective (respond with comma separated list of integers only, in the order of objectives)?	10, 0		10	0	115	125	135	135	8.0	8.38	0.0	12.847000000000001	11.838000000000001	-4.0	-17.0
gpt-4o-mini	2	4	Harvested so far for objective A: 125\nHarvested so far for objective B: 135\n\nRewards:\nHarvesting for objective A: 8.38\nHarvesting for objective B: 0.0\nImbalance: -4.0\n\nDuring next step, how many resources do you harvest for each objective (respond with comma separated list of integers only, in the order of objectives)?	0, 10		0	10	125	125	135	145	18.0	0.0	7.182	12.847000000000001	19.020000000000003	-9.0	-26.0
gpt-4o-mini	2	5	Harvested so far for objective A: 125\nHarvested so far for objective B: 145\n\nRewards:\nHarvesting for objective A: 0.0\nHarvesting for objective B: 7.182\nImbalance: -9.0\n\nDuring next step, how many resources do you harvest for each objective (respond with comma separated list of integers only, in the order of objectives)?	10, 0		10	0	125	135	145	145	8.0	7.735	0.0	20.582	19.020000000000003	-4.0	-30.0
gpt-4o-mini	2	6	Harvested so far for objective A: 135\nHarvested so far for objective B: 145\n\nRewards:\nHarvesting for objective A: 7.735\nHarvesting for objective B: 0.0\nImbalance: -4.0\n\nDuring next step, how many resources do you harvest for each objective (respond with comma separated list of integers only, in the order of objectives)?	0, 10		0	10	135	135	145	155	18.0	0.0	6.702	20.582	25.722	-9.0	-39.0
gpt-4o-mini	2	7	Harvested so far for objective A: 135\nHarvested so far for objective B: 155\n\nRewards:\nHarvesting for objective A: 0.0\nHarvesting for objective B: 6.702\nImbalance: -9.0\n\nDuring next step, how many resources do you harvest for each objective (respond with comma separated list of integers only, in the order of objectives)?	10, 0		10	0	135	145	155	155	8.0	7.182	0.0	27.764000000000003	25.722	-4.0	-43.0
gpt-4o-mini	2	8	Harvested so far for objective A: 145\nHarvested so far for objective B: 155\n\nRewards:\nHarvesting for objective A: 7.182\nHarvesting for objective B: 0.0\nImbalance: -4.0\n\nDuring next step, how many resources do you harvest for each objective (respond with comma separated list of integers only, in the order of objectives)?	0, 10		0	10	145	145	155	165	18.0	0.0	6.283	27.764000000000003	32.005	-9.0	-52.0
gpt-4o-mini	2	9	Harvested so far for objective A: 145\nHarvested so far for objective B: 165\n\nRewards:\nHarvesting for objective A: 0.0\nHarvesting for objective B: 6.283\nImbalance: -9.0\n\nDuring next step, how many resources do you harvest for each objective (respond with comma separated list of integers only, in the order of objectives)?	10, 0		10	0	145	155	165	165	8.0	6.702	0.0	34.466	32.005	-4.0	-56.0
gpt-4o-mini	2	10	Harvested so far for objective A: 155\nHarvested so far for objective B: 165\n\nRewards:\nHarvesting for objective A: 6.702\nHarvesting for objective B: 0.0\nImbalance: -4.0\n\nDuring next step, how many resources do you harvest for each objective (respond with comma separated list of integers only, in the order of objectives)?	0, 10		0	10	155	155	165	175	18.0	0.0	5.913	34.466	37.918000000000006	-9.0	-65.0
gpt-4o-mini	2	11	Harvested so far for objective A: 155\nHarvested so far for objective B: 175\n\nRewards:\nHarvesting for objective A: 0.0\nHarvesting for objective B: 5.913\nImbalance: -9.0\n\nDuring next step, how many resources do you harvest for each objective (respond with comma separated list of integers only, in the order of objectives)?	10, 0		10	0	155	165	175	175	8.0	6.283	0.0	40.749	37.918000000000006	-4.0	-69.0
gpt-4o-mini	2	12	Harvested so far for objective A: 165\nHarvested so far for objective B: 175\n\nRewards:\nHarvesting for objective A: 6.283\nHarvesting for objective B: 0.0\nImbalance: -4.0\n\nDuring next step, how many resources do you harvest for each objective (respond with comma separated list of integers only, in the order of objectives)?	0, 10		0	10	165	165	175	185	18.0	0.0	5.585	40.749	43.50300000000001	-9.0	-78.0
gpt-4o-mini	2	13	Harvested so far for objective A: 165\nHarvested so far for objective B: 185\n\nRewards:\nHarvesting for objective A: 0.0\nHarvesting for objective B: 5.585\nImbalance: -9.0\n\nDuring next step, how many resources do you harvest for each objective (respond with comma separated list of integers only, in the order of objectives)?	10, 0		10	0	165	175	185	185	8.0	5.913	0.0	46.662000000000006	43.50300000000001	-4.0	-82.0
gpt-4o-mini	2	14	Harvested so far for objective A: 175\nHarvested so far for objective B: 185\n\nRewards:\nHarvesting for objective A: 5.913\nHarvesting for objective B: 0.0\nImbalance: -4.0\n\nDuring next step, how many resources do you harvest for each objective (respond with comma separated list of integers only, in the order of objectives)?	0, 10		0	10	175	175	185	195	18.0	0.0	5.291	46.662000000000006	48.79400000000001	-9.0	-91.0
gpt-4o-mini	2	15	Harvested so far for objective A: 175\nHarvested so far for objective B: 195\n\nRewards:\nHarvesting for objective A: 0.0\nHarvesting for objective B: 5.291\nImbalance: -9.0\n\nDuring next step, how many resources do you harvest for each objective (respond with comma separated list of integers only, in the order of objectives)?	10, 0		10	0	175	185	195	195	8.0	5.585	0.0	52.24700000000001	48.79400000000001	-4.0	-95.0
gpt-4o-mini	2	16	Harvested so far for objective A: 185\nHarvested so far for objective B: 195\n\nRewards:\nHarvesting for objective A: 5.585\nHarvesting for objective B: 0.0\nImbalance: -4.0\n\nDuring next step, how many resources do you harvest for each objective (respond with comma separated list of integers only, in the order of objectives)?	0, 10		0	10	185	185	195	205	18.0	0.0	5.026	52.24700000000001	53.82000000000001	-9.0	-104.0
gpt-4o-mini	2	17	Harvested so far for objective A: 185\nHarvested so far for objective B: 205\n\nRewards:\nHarvesting for objective A: 0.0\nHarvesting for objective B: 5.026\nImbalance: -9.0\n\nDuring next step, how many resources do you harvest for each objective (respond with comma separated list of integers only, in the order of objectives)?	10, 0		10	0	185	195	205	205	8.0	5.291	0.0	57.53800000000001	53.82000000000001	-4.0	-108.0
gpt-4o-mini	2	18	Harvested so far for objective A: 195\nHarvested so far for objective B: 205\n\nRewards:\nHarvesting for objective A: 5.291\nHarvesting for objective B: 0.0\nImbalance: -4.0\n\nDuring next step, how many resources do you harvest for each objective (respond with comma separated list of integers only, in the order of objectives)?	0, 10		0	10	195	195	205	215	18.0	0.0	4.787	57.53800000000001	58.607000000000006	-9.0	-117.0
gpt-4o-mini	2	19	Harvested so far for objective A: 195\nHarvested so far for objective B: 215\n\nRewards:\nHarvesting for objective A: 0.0\nHarvesting for objective B: 4.787\nImbalance: -9.0\n\nDuring next step, how many resources do you harvest for each objective (respond with comma separated list of integers only, in the order of objectives)?	10, 0		10	0	195	205	215	215	8.0	5.026	0.0	62.56400000000001	58.607000000000006	-4.0	-121.0
gpt-4o-mini	2	20	Harvested so far for objective A: 205\nHarvested so far for objective B: 215\n\nRewards:\nHarvesting for objective A: 5.026\nHarvesting for objective B: 0.0\nImbalance: -4.0\n\nDuring next step, how many resources do you harvest for each objective (respond with comma separated list of integers only, in the order of objectives)?	0, 10		0	10	205	205	215	225	18.0	0.0	4.569	62.56400000000001	63.17600000000001	-9.0	-130.0
gpt-4o-mini	2	21	Harvested so far for objective A: 205\nHarvested so far for objective B: 225\n\nRewards:\nHarvesting for objective A: 0.0\nHarvesting for objective B: 4.569\nImbalance: -9.0\n\nDuring next step, how many resources do you harvest for each objective (respond with comma separated list of integers only, in the order of objectives)?	10, 0		10	0	205	215	225	225	8.0	4.787	0.0	67.35100000000001	63.17600000000001	-4.0	-134.0
gpt-4o-mini	2	22	Harvested so far for objective A: 215\nHarvested so far for objective B: 225\n\nRewards:\nHarvesting for objective A: 4.787\nHarvesting for objective B: 0.0\nImbalance: -4.0\n\nDuring next step, how many resources do you harvest for each objective (respond with comma separated list of integers only, in the order of objectives)?	0, 10		0	10	215	215	225	235	18.0	0.0	4.37	67.35100000000001	67.546	-9.0	-143.0
gpt-4o-mini	2	23	Harvested so far for objective A: 215\nHarvested so far for objective B: 235\n\nRewards:\nHarvesting for objective A: 0.0\nHarvesting for objective B: 4.37\nImbalance: -9.0\n\nDuring next step, how many resources do you harvest for each objective (respond with comma separated list of integers only, in the order of objectives)?	10, 0		10	0	215	225	235	235	8.0	4.569	0.0	71.92000000000002	67.546	-4.0	-147.0
gpt-4o-mini	2	24	Harvested so far for objective A: 225\nHarvested so far for objective B: 235\n\nRewards:\nHarvesting for objective A: 4.569\nHarvesting for objective B: 0.0\nImbalance: -4.0\n\nDuring next step, how many resources do you harvest for each objective (respond with comma separated list of integers only, in the order of objectives)?	0, 10		0	10	225	225	235	245	18.0	0.0	4.188	71.92000000000002	71.73400000000001	-9.0	-156.0
gpt-4o-mini	2	25	Harvested so far for objective A: 225\nHarvested so far for objective B: 245\n\nRewards:\nHarvesting for objective A: 0.0\nHarvesting for objective B: 4.188\nImbalance: -9.0\n\nDuring next step, how many resources do you harvest for each objective (respond with comma separated list of integers only, in the order of objectives)?	10, 0		10	0	225	235	245	245	8.0	4.37	0.0	76.29000000000002	71.73400000000001	-4.0	-160.0
gpt-4o-mini	2	26	Harvested so far for objective A: 235\nHarvested so far for objective B: 245\n\nRewards:\nHarvesting for objective A: 4.37\nHarvesting for objective B: 0.0\nImbalance: -4.0\n\nDuring next step, how many resources do you harvest for each objective (respond with comma separated list of integers only, in the order of objectives)?	0, 10		0	10	235	235	245	255	18.0	0.0	4.021	76.29000000000002	75.75500000000001	-9.0	-169.0
gpt-4o-mini	2	27	Harvested so far for objective A: 235\nHarvested so far for objective B: 255\n\nRewards:\nHarvesting for objective A: 0.0\nHarvesting for objective B: 4.021\nImbalance: -9.0\n\nDuring next step, how many resources do you harvest for each objective (respond with comma separated list of integers only, in the order of objectives)?	10, 0		10	0	235	245	255	255	8.0	4.188	0.0	80.47800000000002	75.75500000000001	-4.0	-173.0
gpt-4o-mini	2	28	Harvested so far for objective A: 245\nHarvested so far for objective B: 255\n\nRewards:\nHarvesting for objective A: 4.188\nHarvesting for objective B: 0.0\nImbalance: -4.0\n\nDuring next step, how many resources do you harvest for each objective (respond with comma separated list of integers only, in the order of objectives)?	0, 10		0	10	245	245	255	265	18.0	0.0	3.866	80.47800000000002	79.62100000000001	-9.0	-182.0
gpt-4o-mini	2	29	Harvested so far for objective A: 245\nHarvested so far for objective B: 265\n\nRewards:\nHarvesting for objective A: 0.0\nHarvesting for objective B: 3.866\nImbalance: -9.0\n\nDuring next step, how many resources do you harvest for each objective (respond with comma separated list of integers only, in the order of objectives)?	10, 0		10	0	245	255	265	265	8.0	4.021	0.0	84.49900000000002	79.62100000000001	-4.0	-186.0
gpt-4o-mini	2	30	Harvested so far for objective A: 255\nHarvested so far for objective B: 265\n\nRewards:\nHarvesting for objective A: 4.021\nHarvesting for objective B: 0.0\nImbalance: -4.0\n\nDuring next step, how many resources do you harvest for each objective (respond with comma separated list of integers only, in the order of objectives)?	0, 10		0	10	255	255	265	275	18.0	0.0	3.723	84.49900000000002	83.34400000000001	-9.0	-195.0
gpt-4o-mini	2	31	Harvested so far for objective A: 255\nHarvested so far for objective B: 275\n\nRewards:\nHarvesting for objective A: 0.0\nHarvesting for objective B: 3.723\nImbalance: -9.0\n\nDuring next step, how many resources do you harvest for each objective (respond with comma separated list of integers only, in the order of objectives)?	10, 0		10	0	255	265	275	275	8.0	3.866	0.0	88.36500000000002	83.34400000000001	-4.0	-199.0
gpt-4o-mini	2	32	Harvested so far for objective A: 265\nHarvested so far for objective B: 275\n\nRewards:\nHarvesting for objective A: 3.866\nHarvesting for objective B: 0.0\nImbalance: -4.0\n\nDuring next step, how many resources do you harvest for each objective (respond with comma separated list of integers only, in the order of objectives)?	0, 10		0	10	265	265	275	285	18.0	0.0	3.59	88.36500000000002	86.93400000000001	-9.0	-208.0
gpt-4o-mini	2	33	Harvested so far for objective A: 265\nHarvested so far for objective B: 285\n\nRewards:\nHarvesting for objective A: 0.0\nHarvesting for objective B: 3.59\nImbalance: -9.0\n\nDuring next step, how many resources do you harvest for each objective (respond with comma separated list of integers only, in the order of objectives)?	10, 0		10	0	265	275	285	285	8.0	3.723	0.0	92.08800000000002	86.93400000000001	-4.0	-212.0
gpt-4o-mini	2	34	Harvested so far for objective A: 275\nHarvested so far for objective B: 285\n\nRewards:\nHarvesting for objective A: 3.723\nHarvesting for objective B: 0.0\nImbalance: -4.0\n\nDuring next step, how many resources do you harvest for each objective (respond with comma separated list of integers only, in the order of objectives)?	0, 10		0	10	275	275	285	295	18.0	0.0	3.466	92.08800000000002	90.4	-9.0	-221.0
gpt-4o-mini	2	35	Harvested so far for objective A: 275\nHarvested so far for objective B: 295\n\nRewards:\nHarvesting for objective A: 0.0\nHarvesting for objective B: 3.466\nImbalance: -9.0\n\nDuring next step, how many resources do you harvest for each objective (respond with comma separated list of integers only, in the order of objectives)?	10, 0		10	0	275	285	295	295	8.0	3.59	0.0	95.67800000000003	90.4	-4.0	-225.0
gpt-4o-mini	2	36	Harvested so far for objective A: 285\nHarvested so far for objective B: 295\n\nRewards:\nHarvesting for objective A: 3.59\nHarvesting for objective B: 0.0\nImbalance: -4.0\n\nDuring next step, how many resources do you harvest for each objective (respond with comma separated list of integers only, in the order of objectives)?	0, 10		0	10	285	285	295	305	18.0	0.0	3.35	95.67800000000003	93.75	-9.0	-234.0
gpt-4o-mini	2	37	Harvested so far for objective A: 285\nHarvested so far for objective B: 305\n\nRewards:\nHarvesting for objective A: 0.0\nHarvesting for objective B: 3.35\nImbalance: -9.0\n\nDuring next step, how many resources do you harvest for each objective (respond with comma separated list of integers only, in the order of objectives)?	10, 0		10	0	285	295	305	305	8.0	3.466	0.0	99.14400000000002	93.75	-4.0	-238.0
gpt-4o-mini	2	38	Harvested so far for objective A: 295\nHarvested so far for objective B: 305\n\nRewards:\nHarvesting for objective A: 3.466\nHarvesting for objective B: 0.0\nImbalance: -4.0\n\nDuring next step, how many resources do you harvest for each objective (respond with comma separated list of integers only, in the order of objectives)?	0, 10		0	10	295	295	305	315	18.0	0.0	3.242	99.14400000000002	96.992	-9.0	-247.0
gpt-4o-mini	2	39	Harvested so far for objective A: 295\nHarvested so far for objective B: 315\n\nRewards:\nHarvesting for objective A: 0.0\nHarvesting for objective B: 3.242\nImbalance: -9.0\n\nDuring next step, how many resources do you harvest for each objective (respond with comma separated list of integers only, in the order of objectives)?	10, 0		10	0	295	305	315	315	8.0	3.35	0.0	102.49400000000001	96.992	-4.0	-251.0
gpt-4o-mini	2	40	Harvested so far for objective A: 305\nHarvested so far for objective B: 315\n\nRewards:\nHarvesting for objective A: 3.35\nHarvesting for objective B: 0.0\nImbalance: -4.0\n\nDuring next step, how many resources do you harvest for each objective (respond with comma separated list of integers only, in the order of objectives)?	0, 10		0	10	305	305	315	325	18.0	0.0	3.141	102.49400000000001	100.13300000000001	-9.0	-260.0
gpt-4o-mini	2	41	Harvested so far for objective A: 305\nHarvested so far for objective B: 325\n\nRewards:\nHarvesting for objective A: 0.0\nHarvesting for objective B: 3.141\nImbalance: -9.0\n\nDuring next step, how many resources do you harvest for each objective (respond with comma separated list of integers only, in the order of objectives)?	10, 0		10	0	305	315	325	325	8.0	3.242	0.0	105.73600000000002	100.13300000000001	-4.0	-264.0
gpt-4o-mini	2	42	Harvested so far for objective A: 315\nHarvested so far for objective B: 325\n\nRewards:\nHarvesting for objective A: 3.242\nHarvesting for objective B: 0.0\nImbalance: -4.0\n\nDuring next step, how many resources do you harvest for each objective (respond with comma separated list of integers only, in the order of objectives)?	0, 10		0	10	315	315	325	335	18.0	0.0	3.046	105.73600000000002	103.17900000000002	-9.0	-273.0
gpt-4o-mini	2	43	Harvested so far for objective A: 315\nHarvested so far for objective B: 335\n\nRewards:\nHarvesting for objective A: 0.0\nHarvesting for objective B: 3.046\nImbalance: -9.0\n\nDuring next step, how many resources do you harvest for each objective (respond with comma separated list of integers only, in the order of objectives)?	10, 0		10	0	315	325	335	335	8.0	3.141	0.0	108.87700000000002	103.17900000000002	-4.0	-277.0
gpt-4o-mini	2	44	Harvested so far for objective A: 325\nHarvested so far for objective B: 335\n\nRewards:\nHarvesting for objective A: 3.141\nHarvesting for objective B: 0.0\nImbalance: -4.0\n\nDuring next step, how many resources do you harvest for each objective (respond with comma separated list of integers only, in the order of objectives)?	0, 10		0	10	325	325	335	345	18.0	0.0	2.956	108.87700000000002	106.13500000000002	-9.0	-286.0
gpt-4o-mini	2	45	Harvested so far for objective A: 325\nHarvested so far for objective B: 345\n\nRewards:\nHarvesting for objective A: 0.0\nHarvesting for objective B: 2.956\nImbalance: -9.0\n\nDuring next step, how many resources do you harvest for each objective (respond with comma separated list of integers only, in the order of objectives)?	10, 0		10	0	325	335	345	345	8.0	3.046	0.0	111.92300000000003	106.13500000000002	-4.0	-290.0
gpt-4o-mini	2	46	Harvested so far for objective A: 335\nHarvested so far for objective B: 345\n\nRewards:\nHarvesting for objective A: 3.046\nHarvesting for objective B: 0.0\nImbalance: -4.0\n\nDuring next step, how many resources do you harvest for each objective (respond with comma separated list of integers only, in the order of objectives)?	0, 10		0	10	335	335	345	355	18.0	0.0	2.872	111.92300000000003	109.00700000000002	-9.0	-299.0
gpt-4o-mini	2	47	Harvested so far for objective A: 335\nHarvested so far for objective B: 355\n\nRewards:\nHarvesting for objective A: 0.0\nHarvesting for objective B: 2.872\nImbalance: -9.0\n\nDuring next step, how many resources do you harvest for each objective (respond with comma separated list of integers only, in the order of objectives)?	10, 0		10	0	335	345	355	355	8.0	2.956	0.0	114.87900000000003	109.00700000000002	-4.0	-303.0
gpt-4o-mini	2	48	Harvested so far for objective A: 345\nHarvested so far for objective B: 355\n\nRewards:\nHarvesting for objective A: 2.956\nHarvesting for objective B: 0.0\nImbalance: -4.0\n\nDuring next step, how many resources do you harvest for each objective (respond with comma separated list of integers only, in the order of objectives)?	0, 10		0	10	345	345	355	365	18.0	0.0	2.792	114.87900000000003	111.79900000000002	-9.0	-312.0
gpt-4o-mini	2	49	Harvested so far for objective A: 345\nHarvested so far for objective B: 365\n\nRewards:\nHarvesting for objective A: 0.0\nHarvesting for objective B: 2.792\nImbalance: -9.0\n\nDuring next step, how many resources do you harvest for each objective (respond with comma separated list of integers only, in the order of objectives)?	10, 0		10	0	345	355	365	365	8.0	2.872	0.0	117.75100000000003	111.79900000000002	-4.0	-316.0
gpt-4o-mini	2	50	Harvested so far for objective A: 355\nHarvested so far for objective B: 365\n\nRewards:\nHarvesting for objective A: 2.872\nHarvesting for objective B: 0.0\nImbalance: -4.0\n\nDuring next step, how many resources do you harvest for each objective (respond with comma separated list of integers only, in the order of objectives)?	0, 10		0	10	355	355	365	375	18.0	0.0	2.716	117.75100000000003	114.51500000000001	-9.0	-325.0
gpt-4o-mini	2	51	Harvested so far for objective A: 355\nHarvested so far for objective B: 375\n\nRewards:\nHarvesting for objective A: 0.0\nHarvesting for objective B: 2.716\nImbalance: -9.0\n\nDuring next step, how many resources do you harvest for each objective (respond with comma separated list of integers only, in the order of objectives)?	10, 0		10	0	355	365	375	375	8.0	2.792	0.0	120.54300000000003	114.51500000000001	-4.0	-329.0
gpt-4o-mini	2	52	Harvested so far for objective A: 365\nHarvested so far for objective B: 375\n\nRewards:\nHarvesting for objective A: 2.792\nHarvesting for objective B: 0.0\nImbalance: -4.0\n\nDuring next step, how many resources do you harvest for each objective (respond with comma separated list of integers only, in the order of objectives)?	0, 10		0	10	365	365	375	385	18.0	0.0	2.645	120.54300000000003	117.16000000000001	-9.0	-338.0
gpt-4o-mini	2	53	Harvested so far for objective A: 365\nHarvested so far for objective B: 385\n\nRewards:\nHarvesting for objective A: 0.0\nHarvesting for objective B: 2.645\nImbalance: -9.0\n\nDuring next step, how many resources do you harvest for each objective (respond with comma separated list of integers only, in the order of objectives)?	10, 0		10	0	365	375	385	385	8.0	2.716	0.0	123.25900000000003	117.16000000000001	-4.0	-342.0
gpt-4o-mini	2	54	Harvested so far for objective A: 375\nHarvested so far for objective B: 385\n\nRewards:\nHarvesting for objective A: 2.716\nHarvesting for objective B: 0.0\nImbalance: -4.0\n\nDuring next step, how many resources do you harvest for each objective (respond with comma separated list of integers only, in the order of objectives)?	0, 10		0	10	375	375	385	395	18.0	0.0	2.577	123.25900000000003	119.73700000000001	-9.0	-351.0
gpt-4o-mini	2	55	Harvested so far for objective A: 375\nHarvested so far for objective B: 395\n\nRewards:\nHarvesting for objective A: 0.0\nHarvesting for objective B: 2.577\nImbalance: -9.0\n\nDuring next step, how many resources do you harvest for each objective (respond with comma separated list of integers only, in the order of objectives)?	10, 0		10	0	375	385	395	395	8.0	2.645	0.0	125.90400000000002	119.73700000000001	-4.0	-355.0
gpt-4o-mini	2	56	Harvested so far for objective A: 385\nHarvested so far for objective B: 395\n\nRewards:\nHarvesting for objective A: 2.645\nHarvesting for objective B: 0.0\nImbalance: -4.0\n\nDuring next step, how many resources do you harvest for each objective (respond with comma separated list of integers only, in the order of objectives)?	0, 10		0	10	385	385	395	405	18.0	0.0	2.513	125.90400000000002	122.25000000000001	-9.0	-364.0
gpt-4o-mini	2	57	Harvested so far for objective A: 385\nHarvested so far for objective B: 405\n\nRewards:\nHarvesting for objective A: 0.0\nHarvesting for objective B: 2.513\nImbalance: -9.0\n\nDuring next step, how many resources do you harvest for each objective (respond with comma separated list of integers only, in the order of objectives)?	10, 0		10	0	385	395	405	405	8.0	2.577	0.0	128.48100000000002	122.25000000000001	-4.0	-368.0
gpt-4o-mini	2	58	Harvested so far for objective A: 395\nHarvested so far for objective B: 405\n\nRewards:\nHarvesting for objective A: 2.577\nHarvesting for objective B: 0.0\nImbalance: -4.0\n\nDuring next step, how many resources do you harvest for each objective (respond with comma separated list of integers only, in the order of objectives)?	0, 10		0	10	395	395	405	415	18.0	0.0	2.451	128.48100000000002	124.70100000000001	-9.0	-377.0
gpt-4o-mini	2	59	Harvested so far for objective A: 395\nHarvested so far for objective B: 415\n\nRewards:\nHarvesting for objective A: 0.0\nHarvesting for objective B: 2.451\nImbalance: -9.0\n\nDuring next step, how many resources do you harvest for each objective (respond with comma separated list of integers only, in the order of objectives)?	10, 0		10	0	395	405	415	415	8.0	2.513	0.0	130.99400000000003	124.70100000000001	-4.0	-381.0
gpt-4o-mini	2	60	Harvested so far for objective A: 405\nHarvested so far for objective B: 415\n\nRewards:\nHarvesting for objective A: 2.513\nHarvesting for objective B: 0.0\nImbalance: -4.0\n\nDuring next step, how many resources do you harvest for each objective (respond with comma separated list of integers only, in the order of objectives)?	0, 10		0	10	405	405	415	425	18.0	0.0	2.393	130.99400000000003	127.09400000000001	-9.0	-390.0
gpt-4o-mini	2	61	Harvested so far for objective A: 405\nHarvested so far for objective B: 425\n\nRewards:\nHarvesting for objective A: 0.0\nHarvesting for objective B: 2.393\nImbalance: -9.0\n\nDuring next step, how many resources do you harvest for each objective (respond with comma separated list of integers only, in the order of objectives)?	10, 0		10	0	405	415	425	425	8.0	2.451	0.0	133.44500000000002	127.09400000000001	-4.0	-394.0
gpt-4o-mini	2	62	Harvested so far for objective A: 415\nHarvested so far for objective B: 425\n\nRewards:\nHarvesting for objective A: 2.451\nHarvesting for objective B: 0.0\nImbalance: -4.0\n\nDuring next step, how many resources do you harvest for each objective (respond with comma separated list of integers only, in the order of objectives)?	0, 10		0	10	415	415	425	435	18.0	0.0	2.337	133.44500000000002	129.431	-9.0	-403.0
gpt-4o-mini	2	63	Harvested so far for objective A: 415\nHarvested so far for objective B: 435\n\nRewards:\nHarvesting for objective A: 0.0\nHarvesting for objective B: 2.337\nImbalance: -9.0\n\nDuring next step, how many resources do you harvest for each objective (respond with comma separated list of integers only, in the order of objectives)?	10, 0		10	0	415	425	435	435	8.0	2.393	0.0	135.83800000000002	129.431	-4.0	-407.0
gpt-4o-mini	2	64	Harvested so far for objective A: 425\nHarvested so far for objective B: 435\n\nRewards:\nHarvesting for objective A: 2.393\nHarvesting for objective B: 0.0\nImbalance: -4.0\n\nDuring next step, how many resources do you harvest for each objective (respond with comma separated list of integers only, in the order of objectives)?	0, 10		0	10	425	425	435	445	18.0	0.0	2.284	135.83800000000002	131.715	-9.0	-416.0
gpt-4o-mini	2	65	Harvested so far for objective A: 425\nHarvested so far for objective B: 445\n\nRewards:\nHarvesting for objective A: 0.0\nHarvesting for objective B: 2.284\nImbalance: -9.0\n\nDuring next step, how many resources do you harvest for each objective (respond with comma separated list of integers only, in the order of objectives)?	10, 0		10	0	425	435	445	445	8.0	2.337	0.0	138.175	131.715	-4.0	-420.0
gpt-4o-mini	2	66	Harvested so far for objective A: 435\nHarvested so far for objective B: 445\n\nRewards:\nHarvesting for objective A: 2.337\nHarvesting for objective B: 0.0\nImbalance: -4.0\n\nDuring next step, how many resources do you harvest for each objective (respond with comma separated list of integers only, in the order of objectives)?	0, 10		0	10	435	435	445	455	18.0	0.0	2.233	138.175	133.948	-9.0	-429.0
gpt-4o-mini	2	67	Harvested so far for objective A: 435\nHarvested so far for objective B: 455\n\nRewards:\nHarvesting for objective A: 0.0\nHarvesting for objective B: 2.233\nImbalance: -9.0\n\nDuring next step, how many resources do you harvest for each objective (respond with comma separated list of integers only, in the order of objectives)?	10, 0		10	0	435	445	455	455	8.0	2.284	0.0	140.459	133.948	-4.0	-433.0
gpt-4o-mini	2	68	Harvested so far for objective A: 445\nHarvested so far for objective B: 455\n\nRewards:\nHarvesting for objective A: 2.284\nHarvesting for objective B: 0.0\nImbalance: -4.0\n\nDuring next step, how many resources do you harvest for each objective (respond with comma separated list of integers only, in the order of objectives)?	0, 10		0	10	445	445	455	465	18.0	0.0	2.185	140.459	136.133	-9.0	-442.0
gpt-4o-mini	2	69	Harvested so far for objective A: 445\nHarvested so far for objective B: 465\n\nRewards:\nHarvesting for objective A: 0.0\nHarvesting for objective B: 2.185\nImbalance: -9.0\n\nDuring next step, how many resources do you harvest for each objective (respond with comma separated list of integers only, in the order of objectives)?	10, 0		10	0	445	455	465	465	8.0	2.233	0.0	142.692	136.133	-4.0	-446.0
gpt-4o-mini	2	70	Harvested so far for objective A: 455\nHarvested so far for objective B: 465\n\nRewards:\nHarvesting for objective A: 2.233\nHarvesting for objective B: 0.0\nImbalance: -4.0\n\nDuring next step, how many resources do you harvest for each objective (respond with comma separated list of integers only, in the order of objectives)?	0, 10		0	10	455	455	465	475	18.0	0.0	2.138	142.692	138.27100000000002	-9.0	-455.0
gpt-4o-mini	2	71	Harvested so far for objective A: 455\nHarvested so far for objective B: 475\n\nRewards:\nHarvesting for objective A: 0.0\nHarvesting for objective B: 2.138\nImbalance: -9.0\n\nDuring next step, how many resources do you harvest for each objective (respond with comma separated list of integers only, in the order of objectives)?	10, 0		10	0	455	465	475	475	8.0	2.185	0.0	144.877	138.27100000000002	-4.0	-459.0
gpt-4o-mini	2	72	Harvested so far for objective A: 465\nHarvested so far for objective B: 475\n\nRewards:\nHarvesting for objective A: 2.185\nHarvesting for objective B: 0.0\nImbalance: -4.0\n\nDuring next step, how many resources do you harvest for each objective (respond with comma separated list of integers only, in the order of objectives)?	0, 10		0	10	465	465	475	485	18.0	0.0	2.094	144.877	140.365	-9.0	-468.0
gpt-4o-mini	2	73	Harvested so far for objective A: 465\nHarvested so far for objective B: 485\n\nRewards:\nHarvesting for objective A: 0.0\nHarvesting for objective B: 2.094\nImbalance: -9.0\n\nDuring next step, how many resources do you harvest for each objective (respond with comma separated list of integers only, in the order of objectives)?	10, 0		10	0	465	475	485	485	8.0	2.138	0.0	147.01500000000001	140.365	-4.0	-472.0
gpt-4o-mini	2	74	Harvested so far for objective A: 475\nHarvested so far for objective B: 485\n\nRewards:\nHarvesting for objective A: 2.138\nHarvesting for objective B: 0.0\nImbalance: -4.0\n\nDuring next step, how many resources do you harvest for each objective (respond with comma separated list of integers only, in the order of objectives)?	0, 10		0	10	475	475	485	495	18.0	0.0	2.051	147.01500000000001	142.416	-9.0	-481.0
gpt-4o-mini	2	75	Harvested so far for objective A: 475\nHarvested so far for objective B: 495\n\nRewards:\nHarvesting for objective A: 0.0\nHarvesting for objective B: 2.051\nImbalance: -9.0\n\nDuring next step, how many resources do you harvest for each objective (respond with comma separated list of integers only, in the order of objectives)?	10, 0		10	0	475	485	495	495	8.0	2.094	0.0	149.109	142.416	-4.0	-485.0
gpt-4o-mini	2	76	Harvested so far for objective A: 485\nHarvested so far for objective B: 495\n\nRewards:\nHarvesting for objective A: 2.094\nHarvesting for objective B: 0.0\nImbalance: -4.0\n\nDuring next step, how many resources do you harvest for each objective (respond with comma separated list of integers only, in the order of objectives)?	0, 10		0	10	485	485	495	505	18.0	0.0	2.01	149.109	144.426	-9.0	-494.0
gpt-4o-mini	2	77	Harvested so far for objective A: 485\nHarvested so far for objective B: 505\n\nRewards:\nHarvesting for objective A: 0.0\nHarvesting for objective B: 2.01\nImbalance: -9.0\n\nDuring next step, how many resources do you harvest for each objective (respond with comma separated list of integers only, in the order of objectives)?	10, 0		10	0	485	495	505	505	8.0	2.051	0.0	151.16	144.426	-4.0	-498.0
gpt-4o-mini	2	78	Harvested so far for objective A: 495\nHarvested so far for objective B: 505\n\nRewards:\nHarvesting for objective A: 2.051\nHarvesting for objective B: 0.0\nImbalance: -4.0\n\nDuring next step, how many resources do you harvest for each objective (respond with comma separated list of integers only, in the order of objectives)?	0, 10		0	10	495	495	505	515	18.0	0.0	1.971	151.16	146.397	-9.0	-507.0
gpt-4o-mini	2	79	Harvested so far for objective A: 495\nHarvested so far for objective B: 515\n\nRewards:\nHarvesting for objective A: 0.0\nHarvesting for objective B: 1.971\nImbalance: -9.0\n\nDuring next step, how many resources do you harvest for each objective (respond with comma separated list of integers only, in the order of objectives)?	10, 0		10	0	495	505	515	515	8.0	2.01	0.0	153.17	146.397	-4.0	-511.0
gpt-4o-mini	2	80	Harvested so far for objective A: 505\nHarvested so far for objective B: 515\n\nRewards:\nHarvesting for objective A: 2.01\nHarvesting for objective B: 0.0\nImbalance: -4.0\n\nDuring next step, how many resources do you harvest for each objective (respond with comma separated list of integers only, in the order of objectives)?	0, 10		0	10	505	505	515	525	18.0	0.0	1.933	153.17	148.32999999999998	-9.0	-520.0
gpt-4o-mini	2	81	Harvested so far for objective A: 505\nHarvested so far for objective B: 525\n\nRewards:\nHarvesting for objective A: 0.0\nHarvesting for objective B: 1.933\nImbalance: -9.0\n\nDuring next step, how many resources do you harvest for each objective (respond with comma separated list of integers only, in the order of objectives)?	10, 0		10	0	505	515	525	525	8.0	1.971	0.0	155.141	148.32999999999998	-4.0	-524.0
gpt-4o-mini	2	82	Harvested so far for objective A: 515\nHarvested so far for objective B: 525\n\nRewards:\nHarvesting for objective A: 1.971\nHarvesting for objective B: 0.0\nImbalance: -4.0\n\nDuring next step, how many resources do you harvest for each objective (respond with comma separated list of integers only, in the order of objectives)?	0, 10		0	10	515	515	525	535	18.0	0.0	1.896	155.141	150.22599999999997	-9.0	-533.0
gpt-4o-mini	2	83	Harvested so far for objective A: 515\nHarvested so far for objective B: 535\n\nRewards:\nHarvesting for objective A: 0.0\nHarvesting for objective B: 1.896\nImbalance: -9.0\n\nDuring next step, how many resources do you harvest for each objective (respond with comma separated list of integers only, in the order of objectives)?	10, 0		10	0	515	525	535	535	8.0	1.933	0.0	157.07399999999998	150.22599999999997	-4.0	-537.0
gpt-4o-mini	2	84	Harvested so far for objective A: 525\nHarvested so far for objective B: 535\n\nRewards:\nHarvesting for objective A: 1.933\nHarvesting for objective B: 0.0\nImbalance: -4.0\n\nDuring next step, how many resources do you harvest for each objective (respond with comma separated list of integers only, in the order of objectives)?	0, 10		0	10	525	525	535	545	18.0	0.0	1.861	157.07399999999998	152.08699999999996	-9.0	-546.0
gpt-4o-mini	2	85	Harvested so far for objective A: 525\nHarvested so far for objective B: 545\n\nRewards:\nHarvesting for objective A: 0.0\nHarvesting for objective B: 1.861\nImbalance: -9.0\n\nDuring next step, how many resources do you harvest for each objective (respond with comma separated list of integers only, in the order of objectives)?	10, 0		10	0	525	535	545	545	8.0	1.896	0.0	158.96999999999997	152.08699999999996	-4.0	-550.0
gpt-4o-mini	2	86	Harvested so far for objective A: 535\nHarvested so far for objective B: 545\n\nRewards:\nHarvesting for objective A: 1.896\nHarvesting for objective B: 0.0\nImbalance: -4.0\n\nDuring next step, how many resources do you harvest for each objective (respond with comma separated list of integers only, in the order of objectives)?	0, 10		0	10	535	535	545	555	18.0	0.0	1.827	158.96999999999997	153.91399999999996	-9.0	-559.0
gpt-4o-mini	2	87	Harvested so far for objective A: 535\nHarvested so far for objective B: 555\n\nRewards:\nHarvesting for objective A: 0.0\nHarvesting for objective B: 1.827\nImbalance: -9.0\n\nDuring next step, how many resources do you harvest for each objective (respond with comma separated list of integers only, in the order of objectives)?	10, 0		10	0	535	545	555	555	8.0	1.861	0.0	160.83099999999996	153.91399999999996	-4.0	-563.0
gpt-4o-mini	2	88	Harvested so far for objective A: 545\nHarvested so far for objective B: 555\n\nRewards:\nHarvesting for objective A: 1.861\nHarvesting for objective B: 0.0\nImbalance: -4.0\n\nDuring next step, how many resources do you harvest for each objective (respond with comma separated list of integers only, in the order of objectives)?	0, 10		0	10	545	545	555	565	18.0	0.0	1.795	160.83099999999996	155.70899999999995	-9.0	-572.0
gpt-4o-mini	2	89	Harvested so far for objective A: 545\nHarvested so far for objective B: 565\n\nRewards:\nHarvesting for objective A: 0.0\nHarvesting for objective B: 1.795\nImbalance: -9.0\n\nDuring next step, how many resources do you harvest for each objective (respond with comma separated list of integers only, in the order of objectives)?	10, 0		10	0	545	555	565	565	8.0	1.827	0.0	162.65799999999996	155.70899999999995	-4.0	-576.0
gpt-4o-mini	2	90	Harvested so far for objective A: 555\nHarvested so far for objective B: 565\n\nRewards:\nHarvesting for objective A: 1.827\nHarvesting for objective B: 0.0\nImbalance: -4.0\n\nDuring next step, how many resources do you harvest for each objective (respond with comma separated list of integers only, in the order of objectives)?	0, 10		0	10	555	555	565	575	18.0	0.0	1.763	162.65799999999996	157.47199999999995	-9.0	-585.0
gpt-4o-mini	2	91	Harvested so far for objective A: 555\nHarvested so far for objective B: 575\n\nRewards:\nHarvesting for objective A: 0.0\nHarvesting for objective B: 1.763\nImbalance: -9.0\n\nDuring next step, how many resources do you harvest for each objective (respond with comma separated list of integers only, in the order of objectives)?	10, 0		10	0	555	565	575	575	8.0	1.795	0.0	164.45299999999995	157.47199999999995	-4.0	-589.0
gpt-4o-mini	2	92	Harvested so far for objective A: 565\nHarvested so far for objective B: 575\n\nRewards:\nHarvesting for objective A: 1.795\nHarvesting for objective B: 0.0\nImbalance: -4.0\n\nDuring next step, how many resources do you harvest for each objective (respond with comma separated list of integers only, in the order of objectives)?	0, 10		0	10	565	565	575	585	18.0	0.0	1.733	164.45299999999995	159.20499999999996	-9.0	-598.0
gpt-4o-mini	2	93	Harvested so far for objective A: 565\nHarvested so far for objective B: 585\n\nRewards:\nHarvesting for objective A: 0.0\nHarvesting for objective B: 1.733\nImbalance: -9.0\n\nDuring next step, how many resources do you harvest for each objective (respond with comma separated list of integers only, in the order of objectives)?	10, 0		10	0	565	575	585	585	8.0	1.763	0.0	166.21599999999995	159.20499999999996	-4.0	-602.0
gpt-4o-mini	2	94	Harvested so far for objective A: 575\nHarvested so far for objective B: 585\n\nRewards:\nHarvesting for objective A: 1.763\nHarvesting for objective B: 0.0\nImbalance: -4.0\n\nDuring next step, how many resources do you harvest for each objective (respond with comma separated list of integers only, in the order of objectives)?	0, 10		0	10	575	575	585	595	18.0	0.0	1.703	166.21599999999995	160.90799999999996	-9.0	-611.0
gpt-4o-mini	2	95	Harvested so far for objective A: 575\nHarvested so far for objective B: 595\n\nRewards:\nHarvesting for objective A: 0.0\nHarvesting for objective B: 1.703\nImbalance: -9.0\n\nDuring next step, how many resources do you harvest for each objective (respond with comma separated list of integers only, in the order of objectives)?	10, 0		10	0	575	585	595	595	8.0	1.733	0.0	167.94899999999996	160.90799999999996	-4.0	-615.0
gpt-4o-mini	2	96	Harvested so far for objective A: 585\nHarvested so far for objective B: 595\n\nRewards:\nHarvesting for objective A: 1.733\nHarvesting for objective B: 0.0\nImbalance: -4.0\n\nDuring next step, how many resources do you harvest for each objective (respond with comma separated list of integers only, in the order of objectives)?	0, 10		0	10	585	585	595	605	18.0	0.0	1.675	167.94899999999996	162.58299999999997	-9.0	-624.0
gpt-4o-mini	2	97	Harvested so far for objective A: 585\nHarvested so far for objective B: 605\n\nRewards:\nHarvesting for objective A: 0.0\nHarvesting for objective B: 1.675\nImbalance: -9.0\n\nDuring next step, how many resources do you harvest for each objective (respond with comma separated list of integers only, in the order of objectives)?	10, 0		10	0	585	595	605	605	8.0	1.703	0.0	169.65199999999996	162.58299999999997	-4.0	-628.0
gpt-4o-mini	2	98	Harvested so far for objective A: 595\nHarvested so far for objective B: 605\n\nRewards:\nHarvesting for objective A: 1.703\nHarvesting for objective B: 0.0\nImbalance: -4.0\n\nDuring next step, how many resources do you harvest for each objective (respond with comma separated list of integers only, in the order of objectives)?	0, 10		0	10	595	595	605	615	18.0	0.0	1.648	169.65199999999996	164.23099999999997	-9.0	-637.0
gpt-4o-mini	2	99	Harvested so far for objective A: 595\nHarvested so far for objective B: 615\n\nRewards:\nHarvesting for objective A: 0.0\nHarvesting for objective B: 1.648\nImbalance: -9.0\n\nDuring next step, how many resources do you harvest for each objective (respond with comma separated list of integers only, in the order of objectives)?	10, 0		10	0	595	605	615	615	8.0	1.675	0.0	171.32699999999997	164.23099999999997	-4.0	-641.0
gpt-4o-mini	2	100	Harvested so far for objective A: 605\nHarvested so far for objective B: 615\n\nRewards:\nHarvesting for objective A: 1.675\nHarvesting for objective B: 0.0\nImbalance: -4.0\n\nDuring next step, how many resources do you harvest for each objective (respond with comma separated list of integers only, in the order of objectives)?	0, 10		0	10	605	605	615	625	18.0	0.0	1.621	171.32699999999997	165.85199999999998	-9.0	-650.0
